{
    "42883": 22,
    "42881": 20,
    "42882": 20,
    "42887": 20,
    "42884": 19,
    "42885": 19,
    "42886": 19,
    "42895": 9,
    "42899": 9,
    "42896": 9,
    "42892": 9,
    "42906": 9,
    "42894": 9,
    "42891": 9,
    "42905": 9,
    "42904": 9,
    "42893": 9,
    "42900": 8,
    "42888": 8,
    "42898": 8,
    "42890": 8,
    "42902": 8,
    "42889": 8,
    "42897": 8,
    "42901": 7,
    "42910": 7,
    "42912": 7,
    "42903": 7,
    "42913": 7,
    "42909": 6,
    "42911": 6,
    "42916": 6,
    "42914": 5,
    "42908": 5,
    "42924": 4,
    "42907": 4,
    "42917": 4,
    "42919": 4,
    "42922": 4,
    "42920": 4,
    "42915": 4,
    "42926": 4,
    "42918": 4,
    "42927": 4,
    "42921": 3,
    "42930": 3,
    "42923": 3,
    "42925": 3,
    "42933": 2,
    "42932": 2,
    "42936": 2,
    "42929": 2,
    "42928": 2,
    "42931": 2,
    "42947": 1,
    "42938": 1,
    "42942": 1,
    "42941": 1,
    "42939": 1,
    "42944": 1,
    "42940": 1,
    "42949": 1,
    "42937": 1,
    "42934": 1,
    "42935": 1,
    "42946": 1,
    "42960": 0,
    "42953": 0,
    "42982": 0,
    "42990": 0,
    "42985": 0,
    "42987": 0,
    "42988": 0,
    "42959": 0,
    "42993": 0,
    "42991": 0,
    "42974": 0,
    "42975": 0,
    "42984": 0,
    "42981": 0,
    "42973": 0,
    "42971": 0,
    "42986": 0,
    "42983": 0,
    "42972": 0,
    "42989": 0,
    "42961": 0,
    "42992": 0,
    "42954": 0,
    "42945": 0,
    "42956": 0,
    "42948": 0,
    "42969": 0,
    "42968": 0,
    "42967": 0,
    "42952": 0,
    "42966": 0,
    "42963": 0,
    "42943": 0,
    "42957": 0,
    "42950": 0,
    "42964": 0,
    "42951": 0,
    "42962": 0,
    "42965": 0,
    "42955": 0,
    "42958": 0,
    "42970": 0
}
