{
    "42883": 134,
    "42887": 113,
    "42882": 98,
    "42881": 91,
    "42884": 89,
    "42886": 87,
    "42885": 66,
    "42996": 46,
    "42894": 42,
    "42910": 39,
    "42905": 39,
    "42916": 39,
    "42890": 38,
    "42912": 38,
    "42892": 37,
    "42899": 37,
    "42913": 36,
    "42900": 36,
    "42902": 35,
    "42909": 35,
    "42904": 35,
    "42906": 35,
    "42917": 34,
    "42949": 33,
    "42984": 33,
    "42994": 32,
    "42914": 32,
    "42986": 32,
    "42919": 32,
    "42893": 32,
    "42926": 31,
    "42891": 31,
    "42889": 31,
    "42924": 30,
    "42981": 30,
    "42933": 29,
    "42930": 29,
    "42895": 29,
    "42992": 29,
    "42941": 29,
    "42911": 29,
    "42932": 29,
    "42901": 29,
    "42947": 29,
    "42897": 29,
    "42980": 29,
    "42995": 29,
    "42983": 29,
    "42990": 29,
    "42987": 29,
    "42988": 29,
    "42888": 29,
    "42973": 29,
    "42923": 29,
    "42903": 29,
    "42942": 28,
    "42925": 28,
    "42898": 28,
    "42920": 27,
    "42989": 27,
    "42974": 27,
    "42896": 27,
    "42922": 27,
    "42951": 27,
    "42908": 26,
    "42918": 26,
    "42969": 26,
    "42991": 26,
    "42927": 26,
    "42929": 26,
    "42997": 26,
    "42934": 26,
    "42978": 26,
    "42931": 26,
    "42952": 25,
    "42985": 25,
    "42953": 25,
    "42982": 25,
    "42970": 24,
    "42993": 24,
    "42950": 23,
    "42940": 23,
    "42921": 23,
    "42939": 23,
    "42915": 23,
    "42967": 22,
    "42998": 22,
    "42955": 22,
    "42937": 22,
    "42944": 21,
    "42971": 21,
    "42958": 20,
    "42954": 19,
    "42936": 19,
    "42907": 19,
    "42960": 19,
    "42966": 19,
    "42948": 19,
    "42962": 19,
    "42975": 19,
    "42976": 19,
    "42959": 19,
    "42928": 19,
    "42946": 19,
    "42977": 19,
    "42957": 19,
    "42938": 19,
    "42956": 19,
    "42935": 19,
    "42964": 19,
    "42961": 17,
    "42968": 17,
    "42965": 17,
    "42963": 16,
    "42972": 16,
    "42945": 15,
    "42943": 11,
    "42979": 10,
    "43029": 0,
    "42999": 0,
    "43002": 0,
    "43007": 0,
    "43035": 0,
    "43013": 0,
    "43005": 0,
    "43024": 0,
    "43022": 0,
    "43023": 0,
    "43031": 0,
    "43019": 0,
    "43020": 0,
    "43036": 0,
    "43034": 0,
    "43028": 0,
    "43025": 0,
    "43026": 0,
    "43016": 0,
    "43030": 0,
    "43037": 0,
    "43021": 0,
    "43017": 0,
    "43006": 0,
    "43003": 0,
    "43012": 0,
    "43004": 0,
    "43010": 0,
    "43000": 0,
    "43032": 0,
    "43014": 0,
    "43001": 0,
    "43027": 0,
    "43011": 0,
    "43033": 0,
    "43009": 0,
    "43008": 0,
    "43018": 0,
    "43015": 0
}
