{
    "6058": 231,
    "6059": 209,
    "6033": 192,
    "6028": 189,
    "6060": 188,
    "6067": 187,
    "6057": 184,
    "6017": 184,
    "6062": 180,
    "6110": 179,
    "6068": 178,
    "5694": 178,
    "5732": 176,
    "6179": 175,
    "5469": 173,
    "5443": 171,
    "6108": 171,
    "6051": 170,
    "6070": 170,
    "6014": 169,
    "6012": 168,
    "6133": 168,
    "6030": 167,
    "6040": 167,
    "5847": 166,
    "6065": 166,
    "6016": 164,
    "6005": 163,
    "6013": 162,
    "5823": 160,
    "6023": 160,
    "6046": 159,
    "6043": 157,
    "6080": 157,
    "6001": 156,
    "6042": 156,
    "6047": 153,
    "6146": 151,
    "6039": 150,
    "6144": 147,
    "6175": 147,
    "6215": 146,
    "6083": 146,
    "6098": 146,
    "6050": 146,
    "6009": 146,
    "6096": 145,
    "6066": 145,
    "6027": 145,
    "6188": 145,
    "6049": 144,
    "6069": 143,
    "6073": 142,
    "6205": 142,
    "6166": 141,
    "6076": 140,
    "6101": 139,
    "6093": 139,
    "6106": 139,
    "5442": 138,
    "6176": 138,
    "6082": 137,
    "6052": 137,
    "6064": 137,
    "6186": 137,
    "6053": 137,
    "5371": 136,
    "5624": 135,
    "6041": 135,
    "6048": 135,
    "6159": 132,
    "6079": 132,
    "6100": 127,
    "5767": 127,
    "6180": 127,
    "6089": 126,
    "6129": 126,
    "6088": 125,
    "5370": 125,
    "6077": 124,
    "6182": 124,
    "6095": 124,
    "6081": 124,
    "6086": 124,
    "6075": 123,
    "6170": 123,
    "6174": 123,
    "6212": 123,
    "6109": 123,
    "6085": 122,
    "6211": 122,
    "6112": 122,
    "6084": 122,
    "6137": 122,
    "6113": 121,
    "6045": 121,
    "6169": 121,
    "6132": 121,
    "6216": 120,
    "6118": 120,
    "5298": 120,
    "6206": 120,
    "6105": 119,
    "6196": 119,
    "6148": 118,
    "6136": 118,
    "6119": 118,
    "6120": 117,
    "6111": 117,
    "6025": 117,
    "6210": 117,
    "6214": 116,
    "5444": 116,
    "6178": 116,
    "6154": 115,
    "6195": 115,
    "5911": 115,
    "6173": 115,
    "6122": 115,
    "6155": 114,
    "6115": 114,
    "6168": 114,
    "6203": 113,
    "6209": 113,
    "6181": 113,
    "6061": 113,
    "6202": 113,
    "6149": 113,
    "5336": 113,
    "6201": 112,
    "6165": 112,
    "6213": 112,
    "6063": 112,
    "6167": 112,
    "6184": 111,
    "6172": 111,
    "6158": 111,
    "6191": 110,
    "6156": 109,
    "6099": 109,
    "5408": 109,
    "6177": 109,
    "6204": 108,
    "6121": 108,
    "6157": 108,
    "6161": 108,
    "6190": 108,
    "6117": 107,
    "6135": 107,
    "6197": 106,
    "6019": 105,
    "5874": 104,
    "6147": 104,
    "6192": 100,
    "6185": 100,
    "6097": 100,
    "6193": 99,
    "6171": 99,
    "6055": 98,
    "6153": 98,
    "5948": 98,
    "6208": 97,
    "6194": 97,
    "6018": 97,
    "6183": 91,
    "6054": 89,
    "6091": 88,
    "5984": 87,
    "6189": 87,
    "6207": 82,
    "6090": 77,
    "6127": 77,
    "6020": 74,
    "6163": 60,
    "6126": 59,
    "6056": 55,
    "6199": 39,
    "6092": 39,
    "6162": 39,
    "6128": 14,
    "6198": 10
}
