{
    "6059": 612,
    "6058": 565,
    "6060": 373,
    "6033": 363,
    "6067": 359,
    "6028": 351,
    "6057": 346,
    "6017": 341,
    "5694": 337,
    "6068": 336,
    "5443": 335,
    "6133": 328,
    "6179": 326,
    "5469": 320,
    "6110": 320,
    "5732": 314,
    "6062": 311,
    "6014": 309,
    "6108": 301,
    "6051": 296,
    "5847": 294,
    "6012": 291,
    "6016": 288,
    "6030": 288,
    "6070": 286,
    "6013": 286,
    "6001": 286,
    "6040": 284,
    "6065": 282,
    "5823": 277,
    "6080": 277,
    "6023": 275,
    "6043": 274,
    "6046": 273,
    "6098": 273,
    "6005": 272,
    "6027": 269,
    "6050": 263,
    "6144": 262,
    "6042": 262,
    "6175": 259,
    "6069": 259,
    "6049": 259,
    "6039": 259,
    "6101": 258,
    "6009": 256,
    "6066": 255,
    "6188": 253,
    "6146": 253,
    "6106": 252,
    "6083": 252,
    "6166": 252,
    "6073": 252,
    "6052": 252,
    "6096": 251,
    "6047": 250,
    "6205": 247,
    "6064": 246,
    "6215": 246,
    "6048": 244,
    "6093": 244,
    "6053": 243,
    "5371": 241,
    "5624": 241,
    "6082": 241,
    "6089": 241,
    "6176": 240,
    "5442": 239,
    "6076": 239,
    "6211": 236,
    "6186": 235,
    "6081": 234,
    "5767": 233,
    "6159": 233,
    "6109": 233,
    "6148": 232,
    "6120": 231,
    "6180": 231,
    "6079": 230,
    "6041": 230,
    "6088": 230,
    "5370": 230,
    "5298": 229,
    "6154": 228,
    "6212": 228,
    "6095": 228,
    "6216": 227,
    "6086": 226,
    "6210": 226,
    "6112": 226,
    "6136": 226,
    "6137": 225,
    "6100": 225,
    "6113": 224,
    "6206": 224,
    "6084": 224,
    "6170": 223,
    "6105": 223,
    "6174": 222,
    "6129": 221,
    "6149": 221,
    "6045": 221,
    "6168": 219,
    "6061": 219,
    "6191": 219,
    "6182": 219,
    "6085": 219,
    "6167": 218,
    "6075": 218,
    "6214": 218,
    "5444": 218,
    "6172": 217,
    "6201": 216,
    "6181": 216,
    "6118": 216,
    "6077": 216,
    "6132": 215,
    "6119": 215,
    "6111": 215,
    "6156": 214,
    "6122": 214,
    "6169": 213,
    "6025": 212,
    "6196": 211,
    "6203": 211,
    "6165": 211,
    "5408": 209,
    "6213": 209,
    "6121": 208,
    "6115": 208,
    "6158": 208,
    "6155": 207,
    "6019": 207,
    "6173": 206,
    "5911": 206,
    "6099": 205,
    "6178": 204,
    "6117": 204,
    "6202": 204,
    "6209": 204,
    "6184": 203,
    "6195": 203,
    "6161": 203,
    "6177": 200,
    "6097": 200,
    "6204": 199,
    "6063": 199,
    "6190": 198,
    "6208": 197,
    "6171": 197,
    "6193": 196,
    "6055": 196,
    "6153": 196,
    "5336": 196,
    "6135": 195,
    "6185": 194,
    "6192": 194,
    "5948": 193,
    "6018": 192,
    "6127": 192,
    "6091": 192,
    "6090": 191,
    "6157": 190,
    "6183": 189,
    "6207": 189,
    "6189": 189,
    "6197": 189,
    "6054": 188,
    "5984": 188,
    "5874": 186,
    "6020": 185,
    "6147": 184,
    "6092": 182,
    "6194": 181,
    "6126": 181,
    "6163": 179,
    "6162": 178,
    "6199": 177,
    "6198": 175,
    "6164": 168,
    "6200": 164,
    "6128": 163,
    "6056": 160
}
