{
    "44351": 0,
    "44362": 0,
    "44360": 0,
    "44359": 0,
    "44357": 0,
    "44363": 0,
    "44352": 0,
    "44348": 0,
    "44349": 0,
    "44347": 0,
    "44350": 0,
    "44365": 0,
    "44364": 0,
    "44358": 0,
    "44356": 0,
    "44367": 0,
    "44355": 0,
    "44353": 0,
    "44354": 0,
    "44361": 0,
    "44366": 0
}
