{
    "49395": 10137,
    "49391": 9412,
    "49327": 7268,
    "49457": 6886,
    "49339": 6732,
    "49367": 6280,
    "49440": 5728,
    "49380": 4574,
    "49382": 4431,
    "49336": 4418,
    "49357": 4078,
    "49351": 4074,
    "49390": 3875,
    "49449": 3703,
    "49358": 3511,
    "49436": 3186,
    "49329": 3088,
    "49343": 2886,
    "49453": 2761,
    "49353": 2747,
    "49414": 2741,
    "49333": 2695,
    "49442": 2665,
    "49356": 2475,
    "49469": 2407,
    "49445": 2317,
    "49458": 2216,
    "49352": 1899,
    "49468": 1481,
    "49402": 1227,
    "49335": 1205,
    "49338": 956,
    "49456": 736,
    "49362": 618,
    "49340": 439,
    "49455": 399,
    "49471": 0,
    "49459": 0,
    "49473": 0,
    "49470": 0,
    "49472": 0,
    "49450": 0,
    "49467": 0,
    "49465": 0,
    "49466": 0,
    "49448": 0,
    "49378": 0,
    "49454": 0,
    "49451": 0,
    "49416": 0,
    "49366": 0,
    "49452": 0,
    "49447": 0,
    "49435": 0,
    "49400": 0,
    "49398": 0,
    "49396": 0,
    "49386": 0,
    "49374": 0,
    "49430": 0,
    "49405": 0,
    "49397": 0,
    "49387": 0,
    "49381": 0,
    "49464": 0,
    "49403": 0,
    "49446": 0,
    "49433": 0,
    "49383": 0,
    "49376": 0,
    "49437": 0,
    "49439": 0,
    "49418": 0,
    "49399": 0,
    "49384": 0,
    "49379": 0,
    "49375": 0,
    "49371": 0,
    "49369": 0,
    "49463": 0,
    "49460": 0,
    "49443": 0,
    "49441": 0,
    "49432": 0,
    "49431": 0,
    "49429": 0,
    "49428": 0,
    "49422": 0,
    "49421": 0,
    "49419": 0,
    "49417": 0,
    "49407": 0,
    "49406": 0,
    "49401": 0,
    "49393": 0,
    "49385": 0,
    "49373": 0,
    "49372": 0,
    "49368": 0,
    "49365": 0,
    "49364": 0,
    "49363": 0,
    "49361": 0,
    "49348": 0,
    "49462": 0,
    "49461": 0,
    "49434": 0,
    "49427": 0,
    "49426": 0,
    "49425": 0,
    "49424": 0,
    "49423": 0,
    "49420": 0,
    "49415": 0,
    "49412": 0,
    "49409": 0,
    "49408": 0,
    "49404": 0,
    "49394": 0,
    "49392": 0,
    "49389": 0,
    "49360": 0,
    "49359": 0,
    "49355": 0,
    "49354": 0,
    "49350": 0,
    "49347": 0,
    "49345": 0,
    "49344": 0,
    "49342": 0,
    "49337": 0,
    "49334": 0,
    "49332": 0,
    "49331": 0,
    "49330": 0,
    "49444": 0,
    "49413": 0,
    "49411": 0,
    "49410": 0,
    "49388": 0,
    "49370": 0,
    "49349": 0,
    "49346": 0,
    "49341": 0,
    "49328": 0,
    "49326": 0,
    "49438": 0,
    "49377": 0
}
