{
    "6059": 694,
    "6058": 620,
    "6060": 414,
    "6033": 404,
    "6067": 395,
    "6028": 385,
    "6057": 378,
    "6017": 377,
    "5443": 368,
    "5694": 367,
    "6068": 367,
    "6179": 358,
    "6133": 356,
    "6110": 348,
    "5469": 344,
    "5732": 343,
    "6062": 339,
    "6014": 338,
    "6108": 330,
    "6051": 323,
    "5847": 320,
    "6012": 316,
    "6013": 314,
    "6001": 313,
    "6030": 312,
    "6016": 312,
    "6070": 310,
    "6040": 309,
    "6065": 305,
    "5823": 302,
    "6080": 302,
    "6098": 297,
    "6023": 297,
    "6046": 296,
    "6043": 296,
    "6027": 293,
    "6005": 292,
    "6144": 284,
    "6042": 284,
    "6050": 284,
    "6101": 283,
    "6049": 281,
    "6069": 281,
    "6175": 279,
    "6066": 278,
    "6039": 277,
    "6052": 275,
    "6188": 275,
    "6146": 274,
    "6009": 274,
    "6166": 273,
    "6073": 273,
    "6096": 273,
    "6106": 273,
    "6083": 271,
    "6047": 268,
    "6064": 268,
    "6215": 268,
    "6205": 267,
    "6048": 265,
    "6093": 264,
    "6089": 264,
    "5624": 263,
    "6053": 262,
    "6211": 260,
    "5371": 260,
    "6176": 259,
    "6076": 258,
    "6082": 258,
    "5442": 256,
    "6081": 254,
    "6148": 253,
    "6186": 252,
    "5767": 252,
    "6109": 250,
    "6120": 250,
    "6159": 250,
    "6095": 249,
    "5370": 248,
    "6180": 248,
    "6041": 247,
    "6079": 247,
    "6154": 247,
    "5298": 246,
    "6212": 246,
    "6088": 246,
    "6136": 245,
    "6216": 245,
    "6086": 245,
    "6210": 245,
    "6112": 244,
    "6137": 242,
    "6113": 242,
    "6100": 241,
    "6105": 240,
    "6206": 240,
    "6045": 240,
    "6084": 240,
    "6129": 239,
    "6170": 238,
    "6149": 238,
    "6172": 237,
    "6174": 236,
    "6167": 236,
    "6118": 236,
    "6061": 236,
    "6168": 236,
    "6191": 236,
    "6085": 235,
    "5444": 235,
    "6182": 235,
    "6111": 234,
    "6119": 234,
    "6132": 233,
    "6075": 233,
    "6214": 232,
    "6201": 232,
    "6077": 232,
    "6181": 232,
    "6122": 232,
    "6156": 230,
    "6169": 229,
    "6025": 228,
    "6165": 227,
    "5408": 227,
    "6196": 226,
    "6155": 226,
    "6203": 226,
    "6158": 224,
    "6099": 224,
    "6173": 223,
    "6019": 223,
    "6121": 223,
    "6213": 222,
    "5911": 222,
    "6115": 221,
    "6161": 221,
    "6117": 220,
    "6202": 220,
    "6209": 219,
    "6178": 217,
    "6063": 217,
    "6195": 217,
    "6097": 215,
    "6184": 215,
    "6208": 215,
    "6204": 214,
    "6177": 214,
    "6171": 214,
    "5336": 212,
    "6055": 212,
    "6190": 211,
    "6193": 211,
    "6185": 211,
    "6018": 211,
    "6127": 210,
    "6153": 210,
    "6192": 210,
    "6135": 208,
    "5948": 207,
    "6090": 206,
    "6091": 206,
    "6207": 206,
    "6054": 204,
    "6183": 204,
    "6189": 203,
    "6197": 203,
    "6157": 203,
    "5984": 202,
    "5874": 201,
    "6126": 198,
    "6020": 198,
    "6092": 196,
    "6147": 196,
    "6194": 194,
    "6163": 193,
    "6162": 192,
    "6199": 190,
    "6198": 188,
    "6164": 187,
    "6200": 185,
    "6056": 175,
    "6128": 174
}
