{
    "6059": 399,
    "6058": 399,
    "6060": 279,
    "6033": 275,
    "6067": 272,
    "6028": 269,
    "6057": 267,
    "6017": 265,
    "6068": 258,
    "5694": 257,
    "6110": 253,
    "5469": 250,
    "5443": 250,
    "5732": 249,
    "6179": 248,
    "6062": 245,
    "6014": 245,
    "6133": 244,
    "6108": 239,
    "6051": 238,
    "5847": 235,
    "6070": 234,
    "6012": 234,
    "6030": 234,
    "6016": 232,
    "6065": 231,
    "6040": 229,
    "6013": 226,
    "6023": 222,
    "6005": 222,
    "6001": 222,
    "5823": 221,
    "6080": 220,
    "6046": 219,
    "6043": 219,
    "6042": 215,
    "6098": 212,
    "6027": 211,
    "6144": 210,
    "6049": 210,
    "6050": 209,
    "6039": 209,
    "6047": 208,
    "6146": 207,
    "6066": 207,
    "6175": 207,
    "6069": 206,
    "6009": 205,
    "6083": 205,
    "6166": 205,
    "6096": 203,
    "6073": 202,
    "6188": 202,
    "6106": 201,
    "6052": 201,
    "6101": 201,
    "6215": 201,
    "6205": 198,
    "6064": 198,
    "6093": 197,
    "6048": 197,
    "6053": 196,
    "6076": 195,
    "5371": 194,
    "5442": 194,
    "6176": 193,
    "6089": 192,
    "6082": 192,
    "6186": 192,
    "5624": 191,
    "6041": 190,
    "5767": 187,
    "6079": 187,
    "6109": 186,
    "6081": 185,
    "6159": 185,
    "6112": 185,
    "5298": 184,
    "6100": 184,
    "6180": 184,
    "6088": 184,
    "5370": 183,
    "6129": 182,
    "6137": 182,
    "6120": 181,
    "6210": 181,
    "6095": 180,
    "6206": 180,
    "6182": 180,
    "6212": 180,
    "6148": 179,
    "6211": 179,
    "6084": 179,
    "6216": 179,
    "6105": 179,
    "6113": 179,
    "6086": 178,
    "6075": 178,
    "6170": 178,
    "6154": 177,
    "6085": 177,
    "6191": 177,
    "6174": 177,
    "6077": 177,
    "5444": 177,
    "6111": 177,
    "6136": 177,
    "6214": 175,
    "6169": 175,
    "6201": 175,
    "6149": 175,
    "6132": 174,
    "6119": 174,
    "6045": 174,
    "6173": 173,
    "6167": 173,
    "6122": 172,
    "6118": 172,
    "6181": 172,
    "6203": 172,
    "6168": 172,
    "6196": 171,
    "6115": 171,
    "6213": 171,
    "6061": 171,
    "6025": 170,
    "6165": 170,
    "6172": 169,
    "6155": 169,
    "5911": 168,
    "6121": 168,
    "6202": 166,
    "6158": 166,
    "6063": 166,
    "6178": 166,
    "6195": 166,
    "6099": 166,
    "6019": 166,
    "6156": 166,
    "6209": 165,
    "5408": 165,
    "6184": 165,
    "5336": 163,
    "6097": 162,
    "6117": 162,
    "6177": 161,
    "6161": 161,
    "6204": 160,
    "6193": 159,
    "5948": 159,
    "6192": 158,
    "6190": 158,
    "6171": 158,
    "6135": 157,
    "6157": 157,
    "6208": 157,
    "6055": 157,
    "6153": 156,
    "6197": 156,
    "6185": 155,
    "5874": 155,
    "6054": 154,
    "6090": 153,
    "6189": 153,
    "6147": 153,
    "6018": 151,
    "6183": 150,
    "6194": 149,
    "6091": 149,
    "6127": 149,
    "5984": 149,
    "6207": 146,
    "6020": 144,
    "6126": 141,
    "6163": 139,
    "6092": 135,
    "6199": 130,
    "6162": 129,
    "6056": 120,
    "6198": 119,
    "6128": 117,
    "6164": 102,
    "6200": 81
}
