{
    "37558": 36,
    "37561": 30,
    "37559": 29,
    "37562": 29,
    "37554": 29,
    "37552": 29,
    "37553": 29,
    "37556": 29,
    "37578": 28,
    "37580": 28,
    "37565": 28,
    "37584": 28,
    "37574": 28,
    "37575": 28,
    "37583": 27,
    "37572": 27,
    "37557": 27,
    "37567": 27,
    "37560": 27,
    "37573": 26,
    "37569": 26,
    "37568": 26,
    "37581": 25,
    "37587": 25,
    "37563": 25,
    "37585": 24,
    "37586": 24,
    "37555": 23,
    "37582": 22,
    "37579": 22,
    "37576": 22,
    "37602": 9,
    "37600": 8,
    "37606": 7,
    "37595": 4,
    "37607": 3,
    "37614": 2,
    "37593": 2,
    "37594": 2,
    "37613": 2,
    "37601": 1,
    "37621": 1,
    "37597": 1,
    "37592": 1,
    "37598": 1,
    "37603": 1,
    "37596": 1,
    "37577": 0,
    "37608": 0,
    "37619": 0,
    "37645": 0,
    "37654": 0,
    "37616": 0,
    "37591": 0,
    "37566": 0,
    "37636": 0,
    "37635": 0,
    "37641": 0,
    "37644": 0,
    "37657": 0,
    "37564": 0,
    "37658": 0,
    "37571": 0,
    "37589": 0,
    "37611": 0,
    "37648": 0,
    "37650": 0,
    "37656": 0,
    "37605": 0,
    "37620": 0,
    "37626": 0,
    "37649": 0,
    "37639": 0,
    "37623": 0,
    "37622": 0,
    "37629": 0,
    "37609": 0,
    "37618": 0,
    "37630": 0,
    "37643": 0,
    "37638": 0,
    "37653": 0,
    "37637": 0,
    "37634": 0,
    "37651": 0,
    "37627": 0,
    "37640": 0,
    "37647": 0,
    "37615": 0,
    "37599": 0,
    "37659": 0,
    "37652": 0,
    "37612": 0,
    "37642": 0,
    "37570": 0,
    "37588": 0,
    "37604": 0,
    "37610": 0,
    "37624": 0,
    "37655": 0,
    "37625": 0,
    "37628": 0,
    "37617": 0,
    "37590": 0,
    "37631": 0,
    "37633": 0,
    "37632": 0,
    "37646": 0
}
