{
    "6059": 729,
    "6058": 643,
    "6060": 428,
    "6033": 421,
    "6067": 409,
    "6028": 401,
    "6057": 392,
    "6017": 391,
    "5443": 383,
    "6068": 382,
    "5694": 379,
    "6179": 372,
    "6133": 367,
    "6110": 360,
    "5732": 355,
    "5469": 354,
    "6062": 351,
    "6014": 348,
    "6108": 341,
    "6051": 335,
    "5847": 330,
    "6012": 326,
    "6013": 325,
    "6001": 323,
    "6016": 323,
    "6030": 321,
    "6070": 319,
    "6040": 317,
    "6065": 313,
    "5823": 312,
    "6080": 311,
    "6046": 308,
    "6043": 308,
    "6098": 307,
    "6023": 307,
    "6027": 304,
    "6005": 302,
    "6050": 293,
    "6042": 293,
    "6144": 292,
    "6101": 292,
    "6049": 291,
    "6175": 290,
    "6069": 289,
    "6066": 286,
    "6039": 286,
    "6106": 283,
    "6188": 283,
    "6052": 283,
    "6146": 282,
    "6009": 282,
    "6073": 282,
    "6166": 281,
    "6096": 280,
    "6083": 278,
    "6047": 277,
    "6205": 277,
    "6215": 276,
    "6064": 276,
    "6093": 273,
    "6089": 273,
    "6048": 272,
    "5624": 270,
    "6076": 269,
    "6053": 269,
    "6211": 269,
    "6176": 267,
    "6082": 267,
    "5371": 267,
    "5442": 265,
    "6081": 263,
    "6148": 261,
    "6120": 259,
    "6186": 258,
    "5767": 257,
    "6095": 257,
    "6159": 256,
    "6041": 256,
    "6109": 256,
    "6180": 256,
    "6154": 255,
    "5370": 255,
    "6079": 254,
    "6088": 253,
    "6212": 253,
    "6136": 253,
    "6112": 253,
    "5298": 252,
    "6216": 252,
    "6210": 252,
    "6086": 252,
    "6137": 251,
    "6113": 250,
    "6100": 248,
    "6129": 248,
    "6105": 248,
    "6206": 247,
    "6084": 246,
    "6045": 246,
    "6170": 245,
    "6172": 245,
    "6168": 244,
    "6174": 243,
    "6085": 243,
    "6061": 243,
    "6118": 243,
    "6149": 243,
    "6182": 242,
    "6167": 242,
    "6191": 242,
    "6111": 242,
    "5444": 242,
    "6077": 241,
    "6119": 241,
    "6075": 240,
    "6122": 239,
    "6181": 239,
    "6132": 238,
    "6214": 238,
    "6201": 238,
    "6169": 236,
    "6025": 236,
    "6156": 236,
    "6165": 235,
    "6203": 234,
    "6196": 233,
    "5408": 233,
    "6155": 232,
    "6019": 232,
    "6213": 231,
    "6099": 230,
    "6158": 230,
    "6173": 229,
    "6161": 229,
    "5911": 229,
    "6121": 228,
    "6115": 228,
    "6202": 228,
    "6209": 225,
    "6117": 225,
    "6195": 224,
    "6063": 224,
    "6178": 223,
    "6208": 223,
    "6177": 221,
    "6097": 221,
    "6171": 219,
    "6184": 219,
    "6204": 219,
    "5336": 218,
    "6018": 218,
    "6190": 218,
    "6193": 217,
    "6055": 217,
    "6185": 217,
    "6127": 216,
    "6153": 215,
    "6192": 214,
    "6135": 214,
    "5948": 213,
    "6091": 212,
    "6207": 211,
    "6090": 211,
    "6054": 209,
    "6183": 208,
    "6157": 208,
    "6197": 208,
    "5984": 208,
    "6189": 207,
    "5874": 207,
    "6126": 204,
    "6092": 203,
    "6147": 202,
    "6194": 201,
    "6020": 201,
    "6162": 199,
    "6163": 199,
    "6199": 196,
    "6164": 193,
    "6198": 193,
    "6200": 192,
    "6056": 180,
    "6128": 177
}
