{
    "41246": 0,
    "41272": 0,
    "41276": 0,
    "41296": 0,
    "41271": 0,
    "41239": 0,
    "41243": 0,
    "41259": 0,
    "41249": 0,
    "41251": 0,
    "41263": 0,
    "41247": 0,
    "41285": 0,
    "41270": 0,
    "41245": 0,
    "41242": 0,
    "41252": 0,
    "41235": 0,
    "41265": 0,
    "41278": 0,
    "41273": 0,
    "41291": 0,
    "41303": 0,
    "41279": 0,
    "41300": 0,
    "41238": 0,
    "41256": 0,
    "41281": 0,
    "41290": 0,
    "41298": 0,
    "41286": 0,
    "41284": 0,
    "41289": 0,
    "41295": 0,
    "41293": 0,
    "41302": 0,
    "41301": 0,
    "41294": 0,
    "41292": 0,
    "41297": 0,
    "41282": 0,
    "41283": 0,
    "41261": 0,
    "41262": 0,
    "41287": 0,
    "41253": 0,
    "41269": 0,
    "41268": 0,
    "41288": 0,
    "41277": 0,
    "41275": 0,
    "41280": 0,
    "41274": 0,
    "41299": 0
}
