{
    "48241": 22516,
    "48140": 17673,
    "48208": 16101,
    "48171": 13136,
    "48151": 10845,
    "48196": 8521,
    "48189": 8383,
    "48175": 7864,
    "48159": 7326,
    "48224": 7038,
    "48144": 6864,
    "48213": 6605,
    "48230": 6321,
    "48157": 6268,
    "48264": 5691,
    "48186": 5619,
    "48202": 5355,
    "48174": 5094,
    "48220": 5039,
    "48178": 5026,
    "48221": 4941,
    "48179": 4532,
    "48198": 4376,
    "48203": 4264,
    "48209": 4043,
    "48199": 3420,
    "48217": 3096,
    "48201": 2940,
    "48218": 2790,
    "48233": 2678,
    "48236": 2640,
    "48240": 2163,
    "48155": 2136,
    "48242": 2086,
    "48190": 1494,
    "48176": 219,
    "48237": 149,
    "48158": 57,
    "48263": 0,
    "48252": 0,
    "48251": 0,
    "48262": 0,
    "48249": 0,
    "48259": 0,
    "48244": 0,
    "48257": 0,
    "48232": 0,
    "48256": 0,
    "48245": 0,
    "48229": 0,
    "48261": 0,
    "48254": 0,
    "48253": 0,
    "48246": 0,
    "48266": 0,
    "48247": 0,
    "48234": 0,
    "48227": 0,
    "48207": 0,
    "48243": 0,
    "48248": 0,
    "48225": 0,
    "48265": 0,
    "48223": 0,
    "48260": 0,
    "48216": 0,
    "48211": 0,
    "48210": 0,
    "48204": 0,
    "48197": 0,
    "48192": 0,
    "48182": 0,
    "48239": 0,
    "48191": 0,
    "48188": 0,
    "48187": 0,
    "48185": 0,
    "48181": 0,
    "48172": 0,
    "48212": 0,
    "48194": 0,
    "48154": 0,
    "48153": 0,
    "48267": 0,
    "48180": 0,
    "48149": 0,
    "48231": 0,
    "48193": 0,
    "48167": 0,
    "48142": 0,
    "48141": 0,
    "48170": 0,
    "48195": 0,
    "48168": 0,
    "48163": 0,
    "48161": 0,
    "48152": 0,
    "48143": 0,
    "48177": 0,
    "48160": 0,
    "48156": 0,
    "48214": 0,
    "48205": 0,
    "48169": 0,
    "48162": 0,
    "48146": 0,
    "48258": 0,
    "48235": 0,
    "48184": 0,
    "48165": 0,
    "48222": 0,
    "48238": 0,
    "48150": 0,
    "48166": 0,
    "48215": 0,
    "48173": 0,
    "48206": 0,
    "48145": 0,
    "48200": 0,
    "48148": 0,
    "48164": 0,
    "48226": 0,
    "48250": 0,
    "48228": 0
}
